_____________ 3 * width + (width + 1) -> width(4) + 1
| X | O |   |
|---|---|---|
| X |   |   |
|---|---|---|
|   |   |   |
|---|---|---|
